{
  "1": [
    "1            1  1 1D                               ",
    "1                                                  ",
    "1                                                  ",
    "1                  1                               ",
    "1             A        B                           ",
    "1   111111111111   111111111111    111111111111    ",
    "1                                                  ",
    "1                                                  ",
    "1        111                          111          ",
    "1   C                                              ",
    "1           21111111111111      111111111111111    ",
    "1          211111111111111 S                       ",
    "1         21111          D                         ",
    "1        211111              3   1111              ",
    "1       2111111                                    ",
    "111111111111111111111111111111111111111111111111111",
    "111111111111111111111111111111111111111111111111111"
  ],
  "2": [
    "                                                  ",
    "                                                  ",
    "                                                  ",
    "                                                  ",
    "                                                  ",
    "                                                  ",
    "                                                  ",
    "                                                  ",
    "                                                  ",
    "                                                  ",
    "                                                  ",
    "                                                  ",
    "                                                  ",
    "                                                  ",
    "                                                  ",
    "11111111111111111111111111111111111111111111111111",
    "11111111111111111111111111111111111111111111111111"
  ],
  "3": [
    "                                                  ",
    "                                                  ",
    "                                                  ",
    "                                                  ",
    "                                                  ",
    "                                                  ",
    "                                                  ",
    "                                                  ",
    "                                                  ",
    "                                                  ",
    "                                                  ",
    "                                                  ",
    "                                                  ",
    "                                                  ",
    "                                                  ",
    "11111111111111111111111111111111111111111111111111",
    "11111111111111111111111111111111111111111111111111"
  ],
  "_zoom_1": 0.8695652173913045,
  "_offx_1": 0.0,
  "_offy_1": 0.0
}